0000000000000000000000000000000000000000000000000000000000000000000000000000000000000000000000000000
0000000000000000000000000000000000000000000000000000000000000000000000000000000000000000000000000000
0000000000000000000000000000000000000000000000000000000000000000000000000000000000000000000000000000
0000000000000000000000000000000000000000000000000000000000000000000000000000000000000000000000000000
0000000000000000000000000000000000000000000000000000000000000000000000000000000000000000000000000000
0000000000000000000000000000000000000000000000000000000000000000000000000000000000000000000000000000
0000000000000000000000000000000000000000000000000000000000000000000000000000000000000000000000000000
0000000000000000000000000000000000000000000000000000000000000000000000000000000000000000000000000000
0000000000000000000000000000000000000000000000000000000000000000000000000000000000000000000000000000
0000000000000000000000000000000000000000000000000000000000000000000000000000000000000000000000000000
0000000000000000000000000000000000000000000000000000000000000000000000000000000000000000000000000000
0000000000000000000000000000000000000000000000000000000000000000000000000000000000000000000000000000
0000000000000000000000000000000000000000000000000000000000000000000000000000000000000000000000000000
0000000000000000000000000000000000000000000000000000000000000000000000000000000000000000000000000000
0000000000000000000000000000000000000000000000000000000000000000000000000000000000000000000000000000
0000000000000000000000000000000000000000000000000000000000000000000000000000000000000000000000000000
0000000000000000000000000000000000000000000000000000000000000000000000000000000000000000000000000000
0000000000000000000000000000000000000000000000000000000000000000000000000000000000000000000000000000
0000000000000000000000000000000000000000000000000000000000000000000000000000000000000000000000000000
0000000000000000000000000000000000000000000000000000000000000000000000000000000000000000000000000000
0000000000000000000000000000000000000000000000000000000000000000000000000000000000000000000000000000
0000000000000000000000000000000000000000000000000000000000000000000000000000000000000000000000000000
0000000000000000000000000000000000000000000000000000000000000000000000000000000000000000000000000000
0000000000000000000000000000000000000000000000000000000000000000000000000000000000000000000000000000
0000000000000000000000000000000000000000000000000000000000000000000000000000000000000000000000000000
0000000000000000000000000000000000000000000000000000000000000000000000000000000000000000000000000000
0000000000000000000000000000000000000000000000000000000000000000000000000000000000000000000000000000
0000000000000000000000000000000000000000000000000000000000000000000000000000000000000000000000000000
0000000000000000000000000000000000000000000000000000000000000000000000000000000000000000000000000000
0000000000000000000000000000000000000000000000000000000000000000000000000000000000000000000000000000
0000000000000000000000000000000000000000000000000000000000000000000000000000000000000000000000000000
0000000000000000000000000000000000000000000000000000000001111100000000000000000000000000000000000000
0000000000000000000000000000000000001110000000000001111111111100000000000000000000000000000000000000
0000000000000000000000000000000000001110001111111111111111111110000000000000000000000000000000000000
0000000000000000000000000000000011111111001111111111111111001110000000000000000000000000000000000000
0000000000000000000000000000000011111111111111111111110000001110000000000000000000000000000000000000
0000000000000000000000000000000011111111111000000001110000001110000000000000000000000000000000000000
0000000000000000000000000000000011111110111011100000000000001111000000000000000000000000000000000000
0000000000000000000000000000000011111110011111100000000000000111000000000000000000000000000000000000
0000000000000000000000000000000000001110011111110000000000000111000000000000000000000000000000000000
0000000000000000000000000000000000001110011111110000000000000111000000000000000000000000000000000000
0000000000000000000000000000000000001110011111110000000000001111100000000000000000000000000000000000
0000000000000000000000000000000001111111011100000000000000001111100000000000000000000000000000000000
0000000000000000000000000000000001111111000000000000000000001111100000000000000000000000000000000000
0000000000000000000000000000000001111111100000000000000000000011100000000000000000000000000000000000
0000000000000000000000000000000000000011100000000000000000000011100000000000000000000000000000000000
0000000000000000000000000000000000000011100000000000000000000011100000000000000000000000000000000000
0000000000000000000000000000000000000011100000000000000000000011100000000000000000000000000000000000
0000000000000000000000000000000000000011100000000000000011111111100000000000000000000000000000000000
0000000000000000000000000000000000000011100000000000000011111111100000000000000000000000000000000000
0000000000000000000000000000000111110111100000000090000011111110000000000000000000000000000000000000
0000000000000000000000000000000111110111000000000000000001110000000000000000000000000000000000000000
0000000000000000000000000000000111110111100000000000000001110000000000000000000000000000000000000000
0000000000000000000000000000000011100011100000000000000001110000000000000000000000000000000000000000
0000000000000000000000000000000011100011100000000000000001110000000000000000000000000000000000000000
0000000000000000000000000000000000000011100000000000000000000000000000000000000000000000000000000000
0000000000000000000000000000000000000011100000000000000000000000000000000000000000000000000000000000
0000000000000000000000000000000000000000000000000000000000000000000000000000000000000000000000000000
0000000000000000000000000000000000000000000000000000000000000000000000000000000000000000000000000000
0000000000000000000000000000000000000000000000000000000000000000000111110000000000000000000000000000
0000000000000000000000000000000000000000000000000000000000000000000111111111110000000000000000000000
0000000000000000000000000000000000000000000000000000000000000000111111111111110000000000000000000000
0000000000000000000000000111000000000000000000000000000000111111111111111111110000000000000000000000
0000000000000000000000000111111100000000000000000000011111111111111111100000000000000000000000000000
0000000000000000000000000111111111111111000000011111111111111111100000000000000000000000000000000000
0000000000000000000000000001111111111111111111011111111111000000000000000000000000000000000000000000
0000000000000000000000000000000111111111111111111111100000000000000000000000000000000000000000000000
0000000000000000000000000000000000000001111111111111111110000000000000000000000000000000000000000000
0000000000000000000000000000000000000000000001111111111111100000000000000000000000000000000000000000
0000000000000000000000000000000000000000000000000011111111100000000000000000000000000000000000000000
0000000000000000000000000000000000000000000000000000000011100000000000000000000000000000000000000000
0000000000000000000000000000000000000000000000000000000000000000000000000000000000000000000000000000
0000000000000000000000000000000000000000000000000000000000000000000000000000000000000000000000000000
0000000000000000000000000000000000000000000000000000000000000000000000000000000000000000000000000000
0000000000000000000000000000000000000000000000000000000000000000000000000000000000000000000000000000
0000000000000000000000000000000000000000000000000000000000000000000000000000000000000000000000000000
0000000000000000000000000000000000000000000000000000000000000000000000000000000000000000000000000000
0000000000000000000000000000000000000000000000000000000000000000000000000000000000000000000000000000
0000000000000000000000000000000000000000000000000000000000000000000000000000000000000000000000000000
0000000000000000000000000000000000000000000000000000000000000000000000000000000000000000000000000000
0000000000000000000000000000000000000000000000000000000000000000000000000000000000000000000000000000
0000000000000000000000000000000000000000000000000000000000000000000000000000000000000000000000000000
0000000000000000000000000000000000000000000000000000000000000000000000000000000000000000000000000000
0000000000000000000000000000000000000000000000000000000000000000000000000000000000000000000000000000
0000000000000000000000000000000000000000000000000000000000000000000000000000000000000000000000000000
0000000000000000000000000000000000000000000000000000000000000000000000000000000000000000000000000000
0000000000000000000000000000000000000000000000000000000000000000000000000000000000000000000000000000
0000000000000000000000000000000000000000000000000000000000000000000000000000000000000000000000000000
0000000000000000000000000000000000000000000000000000000000000000000000000000000000000000000000000000
0000000000000000000000000000000000000000000000000000000000000000000000000000000000000000000000000000
0000000000000000000000000000000000000000000000000000000000000000000000000000000000000000000000000000
0000000000000000000000000000000000000000000000000000000000000000000000000000000000000000000000000000
0000000000000000000000000000000000000000000000000000000000000000000000000000000000000000000000000000
0000000000000000000000000000000000000000000000000000000000000000000000000000000000000000000000000000
0000000000000000000000000000000000000000000000000000000000000000000000000000000000000000000000000000
0000000000000000000000000000000000000000000000000000000000000000000000000000000000000000000000000000
0000000000000000000000000000000000000000000000000000000000000000000000000000000000000000000000000000
0000000000000000000000000000000000000000000000000000000000000000000000000000000000000000000000000000
0000000000000000000000000000000000000000000000000000000000000000000000000000000000000000000000000000
0000000000000000000000000000000000000000000000000000000000000000000000000000000000000000000000000000
